açak : anahtar
açış- : iç döküşmek, iç dümnyasını birbirine açmak
açma : şarkının giriş kısmı
adakara : avusturalya
adçık : lakap
ademle- : bir olayı anlatmaya gereksiz detay olcak biçimde olayın gerisinden başlamak
ağbat : sinüsodial? vsvs Yumruk yapınca parmaklar
ağcık
ağınç : yükselme, yükseliş, mihraç
ağısangan : asansör, ağsansar
ağısar
ağıyağı : baş düşman
ağma : şarkının yükselen kısmı, prekorus sanırım ama bakmam gerek
ağza-
akalca : pembe
akınak
akma : şarkının akışı, ritm
aktaş : tebeşir mi bu
alakçın : flamingo, al ak çın , alak = penbe
alandaş
algın
alma
alsarı : turuncu
alton : ya kızıl kıyafet ya da alt giysisi
alver
amaçtaş : aynı hedefi olanlar, düşmancası
anaabi : ana abisi
anadaş : hemvalide, annesi bir üvey kardeşler
anak
anakara : asya
andaş : senkron
andırgan
anınç
anlamdaş : eşanlamlı
anlan- : to be understood
anma
anmekan : uzay zaman, space time
antbakanlığı : milli savunma bakanlığı
apaz : minimum, en en en az
apçakara : mü kıtası, ap = yok yokça
arabağ : parmaklardaki ikinci çizgi
arakara : avrasya kısmı
arancı
aranç
arkakara : amerika, amrakkara
artınmak : fazlalık olmak
artışma : aritmatik?
asma
asmayalım : avize
aşaakara : aşakara, afrika. aşağıda
aşatan : restoran müşterisi, aş yaptırttan
aşat- : yemek yaptırmak
aşa- : yemek yapmak
aşıkmak : yemek yapmak
aşılan : sınır, limit, belki uçluk denebilir
aşınç
aşktaş : aynı kişiye aşık oplmuş iki bahtsız ya da bir aşkın iki ucundakiler
aşla : mutfak
aşma
aşoda : mutfak
ataabi : baba abisi
atak
atma
avalak
avalan
ava-
avıkmak : ava çıkmak
avlakara : avrupa, avlandığımız yerdir
avunç : avunuş, avunma hissühali
ayakla-
ayazkara : antartika
ayıkaralık : attention span
ayırda- : fark etmek, ayırt etmek
ayırgı : ayrıt, fark, iki şeyi ayıran şey, farklılık, feature
ayırma
ayırtma
ayıt : aayet, ay- söylemek fiilinden
ayma : verse şarkıda
ayrak
ayrı : gayrı
ayrınç : ayırmaya yarayan şey, features, özellikler
ayrısayrı : ayrı olma hastalığı, dez ve ben
azınç : şehvet ve azgınlık, lust
azma : hızlanma, şarkının itiminin hızlanması
babadaş : bababir üvey kardeşler
bacakbeli : diz
bacakton : pantolon
bağaç- : bağı açmak, çözmek. Sorun çözmek
bağınç
bağırlamak : bağra basmak, sevmek
bağlam-ı başka : context switch(Ceng)
bağlanık : connected, online tarzı
bağrıağır
bakak : göz vs
bakanak : göz
bakarca
bakımsamak : benzemek, bakarak örnek almak tarzı
bakınç
bakıngan : benzeyen
bakışbağı : sokakta yürüyenle bakışırken kurduğun bakışbağı
bakıştır- : birbirine doğru olmayan şeyleri birbirine bakacak hizaya ve doğrultuya sokma
bakma : ilgi
baladaş : ebeveyn
balaş : tatlı yemek, şeker, vs
bala-
balca : tatlı
baldırcak : üstkol
balıkbaşı : belediye başkanı
balıkça : ilçe
balkat : gofret
balsar : ayı
baltuz : baltoz, tozşeker
banç : ba- nç düğüm
barçaan : heran
barkamak : ev, bark almak
barkaşkan : barkaşan, tüccar
barkaşmak : alışveriş, ticaret yapmak
barklıbağa : barklı baka , kaplumbağa
barklık : mahalle
barş : barış, zaman
basak : ayak
basaklamak : tekmelemek
baskamak : yürümek, adımlamak
başağan : başa geçmek isteğen
başama
başa-
başbodun : devletin ana unsuru
başboşalması : head orgasm, asmr
başbuyurgan : başkomutan
başık : başuk, baş- bağlaşmak
başıkmak : baş olma , başkan olma. başıkan, başkan
başıncı : baş olan
başıvar : canlı, insan
başkabodun : yabancı toplumlar
başkarıncalanması : kafakarıncalanması
başton : şapka?
batangün : tırnaktaki beyazlık, günvatımı andırdığı için
batıbodun : avrupa
batkın : diken
bayağıbağlı
bazbodun : teba olan halk
bazıkmak : boyunduruklanmak
bazlık : kul köle, baz  Göktürkçe
bedükteniz : okyanus, tenizrek
beklem : expectation, verwartung
beklenç
bekleşim : deadlock
belbüken : bu dolmatgan ben anlamında mıydı acaba
belek : düzgün
belemek : ortalamak, düzeltmek, dengelemek
belen : belen- + g - denge demek
beleten : düzeltici
belleksiz
bencik : benim içimdeki ben, id?
bene-
benizdeş : doppelganger
benlik
benme : ben olmayanlar, ben me
benmesi
bensi
bensime : ben gibi olmayanlar
benyeğ : narsizim
benzerce
benzeşmez
berigele : since, dünden berigele
beslek : hayvan, evcilleştirilmiş hayvan belki
beşbarmak : el
beşbucak : beşgen
beşçe : pençe
beynemek : anlamak
bezenk : bezenik, süslenmiş
bezgi : bezginlik halühissi
bıkınç : bıkkınlık ve yeterlemek
bırakı
bıyıklık : bıyık çıkan yer, burunaltı, burnaltı
biçi : ot, yeşil
biçki : makas
bikezin : bir keresinde
bilevi : okul ya da uni
bilicilik
bilmegi : cehalet, bilmemek ve dahası
bilmegü : bilinmeyenler
bilmeş
binbasaklı : kırkayak
binbenlik : çoklu kişilik bozukluğu
binbinmekli : bin atlı, ordu sözüdür
binmek : at
birbenlik
bircebolmaz : tek başına olamayan şey, zorunlu varlık
bire-
birleşim : düğün
birleşke
birle-
birolmaan : birolman, başka, farklı
birolmak : birbolmak, denk ve eş olmak
bişimlik : mutfak
bişrük : aş
biti : son
bitişkin : yan yana
bitre : sonra
bitşik : yan yana
bittig : kitap bittiğinde düşülen boşluk hissi
bize-
bizlik : toplum benliği
bodunbuyruk : cumhuriyet
boğazlık : choker
boğunç : boğulma hissiyatı
bolboşluk : evren
bolca : fazla
boşkum : *boşukmak tan vakum demek
boyabeniz : bolmakyajdar
boyak : resim
boyunluk : kolye
boza : ama
bozar- : grileşmek
boztaş : beton
bozuksav : yalan
bölünebilmez : atom
börübodun : orta asya toplumları, bizdenler
bucaksız : daire,yuvar
budek : bugibi
budün : bugünün dün olmuş kısmı, günün yaşanmış olan kesimi
bulak : bulmaya yarayan şey, ipucu clue hint
bulutsu : *bulta- bultak , beyaz
burnamak : koklamak
buyrukbilmez : yaramaz
buyrumca : buyurumcadan, kelam, söz , laf
bücürbağa : kertenkele
bücürbinmek : poni
bükme
bükünlü : hyperbolic
büküntü : manipülasyon
bürgü
bürüncek : kostüm
bürünek : rol
bürüngü : rol
büte : tümü hepi
büyükbalkı : güneş, balkı-
büyüm
büyün
camdam : sunroof
camkafa : aklından ne geçtiği kolayca anlaşılan, saf
canbakanlığı : sağlık bakanlığı
canıvar : canlı
çağrak
çakışım : collision
çalgın : virtuose,hırsız
çalışmaklık : desk
çatkı
çaybelli : hourglass body
çelinç : challenge
çevreleyik : çevreleyik işte etrafını kapsayan, kapsak
çığırtsak : çığılıksak, çığlık atıp rahatlamak isteyen, içi dolu
çıkak : çıkma yeri, exit u kaynak
çıkara
çıkartak
çıkı
çıkıntı : istisna
çıldırman : delişmen
çocukçul : pedofil
çocuktaş : ebeveyn
çoğumsa- : azımsa-
çokla- : olduğundan çok göstermek, beyan etmek , abartmak icabından
çoraplaş- : ötekisiz anlamsızlaşma, bilcebolmaz olmak. Hacivat karagözsüz anlamsızdır
çöle- : çölleşmek, kuraklaşmak, verimsizleşmek tarzı
çöngebiçi : kağıtkalem
çöpe-
çözendüz : mühendis
çözülgen : problem
çükaydı : ereksiyon
çürükdüş : çürüdüş, büyük hayal kırıklığı
dağkuş : dag koş , çif olmayan, non binary
dahadahi : hatta
dalbakanlığı : tarım bakanlığı
dalınç : dalgınlık hali ve hissi
dalışman : kavgacı
damarsuyu : kan, elektrik. Sistemin cansuyu
dardon : latex
darkapak
darkapı : izdiham , darboğaz
dededeş : kuzen
dedirtme : ventrliquist, confessioner
değilme
değkin : kisinden hiçi, nötür, dag ikin
dekberi : zaman aralığı, ordan dek buna beri
delemek : anlamsız konuşmak
delenyel : çok soğuk yel
demse-
denevi : laboratuvar
denik : denilmiş, laf söz,
denim
denizlik : mayo vs
deprenik : depresif
deşer : neşter
dışlaşma : mutual exclusion(ceng)
dışoda : balkon (dalkon)
dışörtü : tişört
dışsöz : iftira
dibidar : KONİ tarzı mı acabp
dikdur : dildo
dikenlikele : oklu, kirpik
dildeş : aynı dili konuşan halk
dilivar : dilli canlı, homo sapiens
dilliçin : papağan
dilsesi : bir dilin kendine has sesleri ve melodisi
dinleşki : demokrasi
dirilmiş : zombi? vs
dişileşik : M2F ci
dişle- : diş göstgermek
dizgindeş
doğrumsu : fuzzy logic tarzı bisi miydi bu
dolak : dolap , batarya, dolan şey
dolama : coil, inductor tarzı mı acaba
dondaş : aynı dona gircek teg samimi, pişti
doygu : fullness
döğüş : havan
dökme : şiir
döne : tekrar ve benzeri
döngün : pişman
dönü : tekrar
durgu : nokta mı bu
durumdaş : hemvaziyet
duvardaş : bitişik odalar
duyak : duyu organı u kulak
duyunmak, : kendi kendine duymak, hissüsezmek
duyurgu
duyuşum : empati
duyuş- : empati kurmak
düğümcük
dünen : dünemekten, akşam
dürtülen : türbülent
dürüce
dürümbez : havlu kağıt
düşdüğün : dream weeding
düşdünya : ütopya
düşgün : düş gibi güzel gün
düşlenik : düşlenilen şey, hayal ve saire
düşünç
düşyer : diyar
düzeydeş : equilevel, aynı seviyedeki kimseler
düzgörü : düzmantık
ederci : enerji
ediştiri
eğimdeş : paralel
elbakanlığı : dışişleri bakanlığı
elce
elektrondaş : covalent bond
elicepte : saygısız
elikmek : kapmak
elser
elyad : kendi ülkene yabancılaşma gibi birşey mi ya da gurbet
epeski : antik
ercik : manlet
erdişi : MTF
ere- : erleşmek, er adam olmak
erilgen : erilmek istenilen yer, tanrı, sevidek vs
erişilgen değişken : global variable(ceng)
erkelliği : male pattern baldness
erkyüzü : hakimiyet erimi
erleşik : F2M olmuş
erslen : ersilen maymun. kaplan arslandan
ertegün : yarın, ya da yarından sonraki gün
erten : erken
eryüzü : insanlarca mesken edilmiş yeryüzü kısmı
esberi : eskiden beri
eskin : eski zamanda
esnetik : lastik
esreten : alkol
esrigen : alkolik
esrik : sarhoş
esriten : alkol
esrütmeler : alkollü içecekler
eşser : zevcelenmek isteyen tarzından
etraz : tarzlar çoğulu, moda
evdeş : housemate, aile
eve- : bir yeri mesken edinmek, ev etmek
ezgen
ezgin : baskın tarzı mıdır
fısıltılık : sır
geçence : akıp giden zaman
geçin : geç zamanda
geçmişser : geçmişe gitmek isteyen, pişman, retrospectte takılıkalan
geçmişseyen : eskiyi özleyen, nostaljiye mahkum
geldirgi : attraction tarzı, gezgingeldiren
geldirmez : engel, obstacle
gele : beri?
gelekli : gerekli ve gelekli, geleceği olan , olabilecek olan şey. gelir bu yani. Riemman ispatı geleksiz
gelgeri
gelişeduran : teknoloji
gelişken : sürekli gelişen şey, teknoloji
gepgerçek : hyperreal
gerbez : tuval
gezdirici : tourist guide, kılavuz
geze
gezgi : trip
gezik : gezilmiş, tourist attraction? vs
gezimci : tourist
girek : enterance
girgi : enterance?
giyiştir- : kombinlemek
göçbakanlığı
göğerti
gökbakanlığı 
göklü : göğe ait olan, celestial
gökre : göğe doğru
gökteş : aynı göğün altında olanlar gibisinde bir tabirden
göktüz : ufuk
gölöcü : van gölü canavarı, loch ness vs
görgün
götürgü
gövdedeş
gözbeneği : gözbebeği
gözdeş : hemfik
göze-
gözgöcü : mirrorage, mirror mirage. Aynaya uzun süre bakma sonucu insan yüzünün bozunup canavarlaşması
gözgüce : aynı
gözlendir- : bakış açısı kazandırmak
gözüküm : appearance
güçbakanlığı
güdünç : beklenti,gütmek vs
güldürgü : humour?
gülgen : çok gülen, gülmeyi huy edinmiş
gülgü : espri? gülme, meme? vs vs
gündüşlemek : daydream
günegü
günen : günemekten sabah
güne- : gün geçirmek, günleri yaşamak
gürlük : nakarat
güventi : garanti
hakbakanlığı : adalet bakanlığı
ısıboru : kalorifer
içbakanlık : iç işleri bakanlığı
içer 
içle- : içine almak,kapsamak vs vs
içtanrı : vicdan
içton : don, içlik, atlet vs
ikilek : papağan, ikile IK , double, tekrar vs
ikileş : tekrar
ikiteker : bisiklet
iklitiye : iki kilit iyesi var, (ceng)
ilbakanlık : çevreüşehircilik bakanlığı
ildeş : hemşeri, fgellow
ileygi : ile ilgili, hakkında
ilgisemek : ilgisek, pikmi
iliştir- : correlate
ilkbağ : parmakların üstündeki üç çizgiden en üstteki
ilkinci : first, firstly vs vs
ilkkişi : adem?
ilyad : gurbette çekilen ülkeözlemi
inere : aşağı kata doğru
ipiç
isteşki : rıza
işbakanlığı : iş ve çalışma bakanlığı
işevi : dükkan
işitek : kulak
işitik : duyulan şey, ses
işitmez, lafdinlemez eşşoğlueşşek.
itik : itilmiş, dışlanmış
itim
itki : motivasyon
izeşim : birbirinin izini sürme,
izeş- : birbirinin izini sürmek, iz sürüşmek
ize- : feyz almak, izini sürmek
izlek
izlenç
izlengi : izleniliyorum hissi
kabukbağlamaz : derin ve iyileşmez, sürekli açılan yara
kaçıntı
kaçkal : fight or flight
kafakarıncalanması : asmr
kafakası : beyin , beyin yaşımsı
kafayaşı : mental age
kalak : kaldırtan şeyler, bir şeyin seni kalmanı sağlayan şeyleri
kalgan : baki
kalık : kalan şey,  kültür tarzı sanırım
kalım : MİRAS tarzı
kalınç
kanca : kankırmızı
kandaş : akraba
kanıdaş
kanınç
kanıvar : canavar, canlı
kanlaç : kalp, yürek
kansar : bloodlust, bloodhungry
kapıkmak : kaplanmak
kaplak : kaplanmış,
kaplı : kablo
karabal : çikolata, karamel.
karaçal- : lekelemek, kirletmek
karakan : mahagony, kara kan rengi. karakanca
karalık : kıta
karayüzü : kıtalar bütünü
karbakanlığı : kaarbakanlığı, ticaret bakalığı
kargaş : kaos
kargaşçı
kaşağı
kaşarası : iki kaş arası
kaşa- : kaş kaldırmak ve oynatma suretiyle duygu belitrme
kata- : katlanmak, kat kat olmak, daha falza katlı olmak
katın- : emrivaki yapıp kendini de plana katmak, va
katlanamaş : katlanamayış, unbear ment
katta : hatta kat+a
kavuşaklık
kavuşkan : mıkantıs
kaygıdaşlık : aynı kaygıya sahip, aynı yaazvaziyette bulunanlar
kayınç
kayırgı : torpil
kazanak : avantaj, kazanmanı sağlayan şey
kazanayazan : bir yarışta ikinci
keçile- : inat etmek
kederdeş : aynı kedere aynı tramvaya sahipler
kendige : kendi olmayan, başka,
kendigen : otokrat, başkan ve tenrikenden
kendileşmek
kenemen : kene gibi yapışıp salmayan yılışık
kenetler : femruarr
kerebir : bir şey eklemeyen söz,  anlamı olmayan, vacous. X kere bir
kertme : to hack, hackleme
kıla-
kılıktaş
kılım
kıpkısa : çok kısa, mini
kırak
kıvranç : cringe
kızılın : güneşin batımında kızıl olduğu an-ı gün
kızınç : hiddet vs
kocadaş : kocanın zevceleri, müslüman erkeğin 4 ten az adette olan karılarının birbirleri ile işikisi
kok
kol : dilek
kolan : isteğen
kola-
kolgan : isteğen
kolgu
koltuksuz : mobilyasız ev
koluk : istenilen şey, arzulanan şey
kolum
koluş- : birbirini istemek
konandurum : conundrum
konuşku : conversation
koşak : running track mi bu
koşgörü : çift görme durumu
koşla-
koşton : kostüm
koşuluk : koşu  pisti
kot- : koydur-
kovkanmak : boşalmak
koyak : koymaya yarayan şey, kutu vb
koygu
koypara : kumbara
koyuk
koyuşturmak : kombinasyon
koyuştur- : inşa etmek, kombinasyon yapmak da vardı sanırım
koyuş-
köke-
köpürgen : karbonlu iöecekler
köpürtmeler : köpürtenlerle aynı
kulaklamak : işitmek
kulaksız : sağır mı bu
kuldurgan : kulturgan, kurtargan ve kul sözcüklerinde kul ettiren gibi birşey
kullanak : kullanma kılavuzu
kumarcıl : kumarbaz
kuranak : setting, ayar
kusukturucu : repugnant
kusunç : repugnant, repulsivr
kuta- : kut almak, vermek anlamında
kükrek : ürkek zıttı, kükreyen
küle-
küntegtün : dönence, gün gece eş
küsken : mızıkçı, sürekli küsen
küskü : küsme halühissi
küsünç : küsme halühissi
lisan-ı insan : insan dili, kişidili, human language
maraşla- : gösterip gösterip vermemek işi
Maraşla- : gösterip vermemek
minyüzon : milyon, binyüzon
nenedeş : kuzen
nerdi : ne erdi? ne oldu
neyişte
niyevar
nötrü : ne ötr, neyden ötürü
nöyle : ne öyle
nözlem
obuşu : o bu ve şu. ötekiler, biz dışındaki her ne
oğlam : oğla-. her hangi bir şeyin alt kesimi
oka-
okun : kitap, bitik
olanbiten
olun : o zaman
oysam : oy-sa-Im. OY isteme oy toplama. Seçim kampanyası vs vaat
öcübörü : werewolf
öcüce : cüce öcü, imp ya da dwarf belki
öcügöz : ne bu eye of cthulhu gibi bir şey mi
öcüsöğüt : treant
öcütöz : hayalet?
ödek
ödekazan : pay2win
ödeş
ödetki : bedel, fiyat
ödyerdeş : öd ve yeri aynı olan şey, kendisi
öğrenser : her şeye meraklı, her şeyi öğrenmek isteyen. Öğrengen
öldürgü : öldürmeye iten dürtü ü neden
öldürtgü
ölek : cinayet mahali belki
öleyazgı : near death experience
ölgü : ölüm, ne bileyim bir şey türet
ölücül : nekrofili
ölümser : suicidal
ölümseyik : suicidal
ölünç : ölme hissiyatıo
ölüöcü : zombi
önberi : önceden beri, çoktan , zaten
öpek : öpülesi yerler, yanak boyun vb
öpke : aniveşiddetli  öpme hissi
öpöz : özün de özü
öpümseyik : kiss deprived
ötücük : bülbül, ötenkuş
övüser : praise kink haver
öyleme : öyle değil
özce : aynı
özdek
öze-
özkendi
özöcü : herkesin içindeki canavar
özölgü : intihar
özölüm : intihar
özyargı : kişinin özü hakkındaki kanıları
paracıl : kapitalist
paralık : cüzdan
parlakça : pırlanta
parlantı : pırlanta
parmakça : ayak paymağı??
pederkeder : tüm dünyanın bahsedegeldiği baba tramvaları
pulbakanlığı : ekonomi bakanlığı
saçlandırıcı : minoxidil
sağnaksevgi : lovebombing
sakallık : sakal çıkan yer
sakınç : sakınma ,
saklak
salık : azat edilmiş
salınç : bıkmaü salma,
samaz : *sa -maz. Herhangi bir neni istemez, çünkü ona sahiptir
sapınç
sarış- : sarılmanın doğrusu bu olmalı gibi sanki
satım
savıkmak : sav sürmek
savlak
savlık : mantık
sayak : saymaya yarayan şey, tally counter
saymagı : disrespect tarzı
seçingi : free will
seçinme : otokrasi
semirgi : kilo?
semizgüreş : sumo güreşi
semrim : kilo almım
semrişki : sağlıklı ilişkide tarafların aldığı kilo
sene-
senge
sesçe : fonem
sevek : sevmeye yarayan şey, yürek ü sevdirici özellikler
seveyazgın
sevilç : sevilme hissi
sevilgi : sevilme hissi
seviştir- : shiplemek, çöpçatanlık yapmak
sevmegi
sevsöv 
sıçak : tuvalet
sıçrak
sıçtırıcı : lavman
sığak : sığa, kapasite  vs
sıkınç : sıkılma halühissi
sınırdaş : komşuülke
sıpsık : inanılmaz sık
sikek : sikilecek yerler, orifices asdfahsdjkgfa
sikinç : sikme arzusu
sikişdaş : fwb
sikmeksemek : sikmek istemek
silgen
size-
solunç
sonamaz
sona- : sonlanmak, bitmek
sonbağ : parmaklardaki sın çizgi
sonuçtaş : aynı sonuca varan önermeler, coninou4m hypothesis ve bilmemne ozan sor
soranak : anket
sorgan : sürekli soru soran, meraklı, felsefeci
sorucul : sorusever, filozof vs
soruk
sorunç
sövgen : küfürbaz
söyle
söylek : telaffuz
söyletken : confessioner?
sözdeş : tutarlı, bir sözü ötekini tutan
sözdeşlik : tutarlılık, güven dahi olabilir
sözgürlük : Freedom Of Speech, düşünce özgürlüğü
sözlük : verse
sözmantığı : semantik
sözse-
söztakısı : sentaksı
suca : mavi,su gibi olan
susak
susaş : thirst
susturuk
susuk
suvlağan : hidrojen
suyüzü : hidrosfer
sünüştür- : gizlemek, üstünü örtmeye çalış, conceal
süredeş
şimşekçe : elektrik
şubür : öbürden
tadak : tat alıcıları
takçıkar
tamuştmak : cennehennem
tanbitig : kutsal kitap
tanrıcak : güçük tanrı
tanrıdaş
tanrımsı : godlike
tanrıra : tanrıya doğru. Tanrıda değil, tanrıya doğru olma, tanrıya doğru gelişmede olan
tanrısayrı
tanrısa-
tanrıtakmaz : agnostik
tanşıksamak : tanışmak istemek
tapınç : hazreti
tapınçlı : hazreti
tapıngı : merhamer
tapmalık : put
tartık : değerli ve düzenli, tartılmış
tavasurat : yüzüdüz
tedirgi
tedirginlik : nervousness
tedirtken
tedrek : şüphe, korku vs
tedrit : tehdit
teklik : tevhit
tekteker : monocycle
tektil : monolingual, tek dilli
tengridemer
tersidüz : palindrom
tırsık : korkak, tırskın
tırsınç : ürkek, korkak, hortlak
titrenç
titretir : vibratör
toplağı : bütünü anlamında mı bu hepsi
toprakça : toprak renginde, kahverengi, toprakla ilgili
torundaş
tözyara : tramva
tutak : kulp
tutunç
tuzluca
tükenç : tükenmişlik haühissi
tükürgen : lama
tümdeş
tümek
tümem : tamam
tüme- : tümlemek, bitirmek
tümünç
türenç
türen-
türeştir-
türevdeş
uçansu : kolonya
uçanyağ : kolonya
uçsöz : abartı
uma : keşke , uma ki ,umola,
umunç
upuç : en en en uç, sınır. Boundary
ura- : kanserlen- kanser ol-
usa- : akıllanmak, akıl yürütmek
usbakanlığı
uyunç
uzaktancı : platonik seven
uzaman : uzay zaman
uzaşk : uzak mesafe aşk, meslek aşkı
uzkan : usta
uzkomak : öteko-, uzağa koymak
uzlan- : doktorla alma- uzmankaşma
uzukmak : ustalaşmak
üçuçlu : üçgen
üfke : üfffffff deme hissi
üfürgü 
üküşünlü : polifonik
ünser : ünlü olmak isteyen zat
üpüst : en üst nokta, maksimum
ürevi : kerhane m
ürkülgen
ürkünç : fright?
ürküngen : kokrkak sissy tarzı
üster : superman
üston
üstünç : üstünlük hissi, kibir
vargıdaş : anı yere varmaya çalışan, adaşça DLT
varışak
varkılan
verek
vurak : davul
vurucu : davulcu
yaaz : yavuzdan kısaltma
yaazalan : kurak alan
yaazkılıklı : kötü er
yadanç
yada- : yabancılamak, yabancılaşmak vs
yağıdaş : ordak düşmanı olan kişiler, düşmandaş, düşmanımın düşmanı
yağınç : düşmanlık hissi
yakaryoğurt : atom denilen acı biberli yoğurt
yaksıyan : oksijen
yalıktırık : elektirik
yalnıkça : insan dili, natural language
yaltırık : elektrik
yalvargan : kul
yamanadam : villain, yaazer
yanağan : papağan, yana- tekrar etmekten
yanarsuyüzü : yeraltındaki lav hattı, alevyüzü
yansöz
yapak
yapık : yapılmış, unoriginal
yapkı
yapyakın : dip dibe, limit.
yapyık : lego, jenga
yaraklık : prezervatif
yarışıncı : rekabetçi
yarıtanrı : semigod, half god
yasa- : yas tutmak
yaslak : bitişik
yaslaş
yaslaşım
yaslaş-
yaşak
yaşaş- : birlikte yaşamak
yaşbakanlığı : gençlik ve spor bakanlığı
yaşbaş : tecrübesiz
yatakçıl : bed rotter, tüm gün yatakta yatan
yavıkmak : kötüleşmek, kötü olmak
yavkan : kötü nen ya da kimse
yavruyurt : kıbrıs
yavuzdua : yamanalkış, beddua
yazak : defter
yazanak
yazgaç : kalem
yazgıç : kalem
yazgıdaş : hemkader
yazıkcağız
yazım : kayıt
yediyanlı : yedigen
yele-
yelgel : pencere, yelin geldiği şey
yelikmek : rüzgar esmek
yelpileter : vantilatör
yemekçil : obur, gluttonous
yemekser : aç vs
yemevi 
yemotağ : mutfak
yenek : avantaj, yenmeye yarayan şey
yerbilen : GPS
yerdeş
yerdeyenik : K.O
yerinç : yerme hissi ve olayı,alay u dalga
yerine
yerineci : vekil
yerlebir : K.O
yerlenmek : yer edinmek
yetinç : şükür
yetiştirgi : terbiye, yetiştirilgi
yılak : mevsim
yıldaş : aynı yıla ait olan şeyler, yılın modası
yıldırım : bezdirgi
yılgı : yılma, pes etme
yılınç : yılgı, yılmak
yıllanık
yırıkmak : şarkı söylemek ya da bestelemek
yokteyl : mocktail
yokunç : yokluk hissi
yola- : yola çıkmak, yolculuğa başlamak
yolbakanlığı : Yol Bakanlığı?
yolbilen : navigasyon
yöndeş
yöne-
yönge : pusula
yöngeç : direksiyon
yurtsar : gurbetçi
yüke-
yükteş : equivalent
yüzdeş : doppelganger
yüzucu : çene
zevkihasret : platoniklik sevgisi
zevktaş : hobideş
erinç:belki:oktay
üzün:hüzün, üzmekten ün eki ile:oktay
vıcıklık:vizkosite:oktay
